NewLabel0=Label files created on 02/12/2026 22:00:04 for label file Id CopilotToolbox and language en-US
 ;Label file comment - see above label
COTXCopilotContext=Copilot Context
COTXCopilotHostContextId=Copilot Context Id
COTXCopilotHostFormContextParameters=Copilot Context Parameters
COTXCopilotEnvironment=Copilot Environment
COTXCopilotAgent=Copilot Agent
COTXEntraId=Entra Id
COTXCopilotSidePanelDisplay=Use Copilot side panel
COTXCopilotParameterView=View Copilot parameters
COTXCopilotParameterMaintain=Maintain Copilot parameters
COTXCopilotUserDuty=Copilot user
COTXCopilotAdminDuty=Copilot administrator
COTXCopilotUserRole=Copilot user role
COTXCopilotAdminRole=Copilot administrator role
COTXDataverseEnvironment=Dataverse Environment
 ;Dataverse environment GUID
COTXAgentSchemaName=Agent Schema Name
 ;Copilot Studio agent schema name in Dataverse
COTXEntraIdAppReg=Entra ID App Registration
 ;Entra ID application registration identifier
COTXEntraIdTenant=Entra ID Tenant
 ;Entra ID tenant identifier
COTXSendGlobalContext=Send Global FSCM Context
 ;Toggle to send global D365 context to Copilot agent
COTXShowToolUsage=Show tool usage
 ;Toggle to show tool call details in chat
COTXShowThoughts=Show thoughts
 ;Toggle to show agent reasoning in chat
COTXKeepConnectionAlive=Keep Connection Alive
 ;Toggle to keep Direct Line connection open when form closes
COTXAgentBehaviour=Agent Behaviour
 ;Agent behaviour configuration section
COTXAvailableIn=Available In
 ;Application area availability configuration
COTXCopilotStudio=Copilot Studio
 ;Copilot Studio configuration section
COTXCopilotAgentAvailability=Copilot Agent Availability
 ;Agent application area mappings
COTXAgentParameters=Agent Parameters
 ;Copilot agent configuration parameters
COTXDataverse=Dataverse
 ;Dataverse configuration section
COTXCopilotAgentAvailabilityDoc=Contains the mapping of application areas to Copilot agent parameter configurations.
 ;Developer documentation for COTXCopilotAgentApplicationAreas table
COTXCopilotAgentParametersDoc=Stores Copilot agent configuration parameters including connection details, authentication, and context settings.
 ;Developer documentation for COTXCopilotAgentParameters table